1:4:10
WEEEEEEcW
W   D   W
W       W
WBBB BBBW
W       W
WBBB BBBW
W       W
WBBB BBBW
W       W
WBBB BBBW
W       W
WWWWPWWWW